1111111111
1000000001
1000200001
1111111101
1000000001
1000001111
1000001001
1000001031
1000001001
1011000001
1001001001
1001001001
1111111111
